111111111111111111111111111111111111111111111111111
1C001000001101000C00000C0000C0000000000000000000001
1111101000000001010010000C0010C00000000000000000001
1010010011010000010010000C0010100000000000000000001
1000000001E10C000C0C000000C000P00000000000000000001
111111111111111111111111111111111111111111111111111