111111111111111111111111111111111111111111111111111
1C000010001101000C0000000000C0000000000000001000001
1111101000000001010010000C0010C000010010010000C0001
101000001101000001001000000010100000000000100010001
1000000001E10C000C0C000000C000P00100100000C00000001
111111111111111111111111111111111111111111111111111